####################
#       #          #
#       #          #
#             #    #
#             #    #
#       #          #
#       #          #
#       #          #
#             #    #
#       #          #
#       #          #
#             #    #
#       #          #
#       #          #
#       #          #
#                  #
#                  #
#       #          #
#       #          #
####################